XXXXXXXXXXXXXXXXXXXX
XU.T.TX...XXXXXXX.XX
XXXXX.X.........X.XX
X...X.XXXXXXX.XXX.XX
X...X.X....|....|.XX
XX-XX.X.XXXXX.XXX.XX
XX....X.XXXXX-XXX.XX
XX.XXXX.XXXXXD|...XX
XX.......XXXX-XXX.XX
XXXXXXXX.XXXX.XXX.XX
X.XXXXXX..........XX
X.XXXXXXXXXXX-XXXXXX
X.XX........|.X....X
X.XX.XXXXXXXX.XDXX.X
X..|.XXXXXXXX.XXXX.X
XXXX......XXX......X
XXXXXXXXXXXXXXXXXXXX
