XXXXXXXXXXXXXXXXXXXX
X.....X...XXXXXXX.XX
XXXXX.X.........X.XX
X...X.XXXXXXX.XXX.XX
X...X.X....|....|.XX
XX-XX.X.XXXXXXXXX.XX
XX....X.XXXXXXXXX.XX
XX.XXXX.XXXXXXXXX.XX
XX.......XXXXXXXX.XX
XXXXXXXX.XXXXXXXX.XX
X.XXXXXX..........XX
X.XXXXXXXXXXX-XXXXXX
X.XX........|.X....X
X.XX.XXXXXXXX.X.XX.X
X..|.XXXXXXXX.XXXX.X
XXXX......XXX......X
XXXXXXXXXXXXXXXXXXXX
